11111111111111111111
10010111010000101101
11011001111101000101
10111000011011001001
11001101110000000001
10110001000001C01111
10000110001001110111
11111000110011100011
100001111C0000000101





1C100000100101000001
110110001E10110100C1
10111110110000100001
11011000001C01001101
111011111000P0000111
11111111111111111111
